x-------------------------------------------x
x-------------------------------------------x
x-------------------------------------------x
x-------------------------------------------x
x-------------------------------------------x
x-------------------------------------------x
x-------------------------------------------x
x-------------------------------------------x
x------------------xxxx---------------------x
x-------------------------------------------x
x-------------------------------------------x
x-----------------x-------------------------x
x-----xxx--------xx-------------------------x
x----xxxxxxx--xxxxxx------------------------x
x----xxxxxxx--xxxxxx------x-----------------x
xxxxxxxxxxxxxxxxxxxxxxxxxxxxxxxxxxxxxxxxxxxxx